     ########
  ####      ######
  #    ## $ $   @#
  # ## ##$#$ $ $##
### ......#  $$ ##
#   ......#  #   #
# # ......#$  $  #
# # ...... $$# $ #
# $ ### ###$  $ ##
###  $  $  $  $ #
  #  $  $  $  $ #
  ######   ######
       #####