       #### 
######## @# 
#  $ $ $ $# 
# #*.  .# ##
#    . #.  #
##$### .   #
 #     #####
 #######    
