   ####  
 ###  ## 
## *   # 
#  ##  ##
#@$*    #
## .# # #
 # *    #
 #  #####
 ####    
