      ####
     ## .#
    ##   #
   ## ...#
#### $$ ##
# @$   ## 
#  $  ##  
#   ###   
#####     
