     #### 
  ####@ # 
  #.* $ # 
###   # ##
#    #.. #
#    $ $ #
####  ####
   ####   
