##############
#            #
#  ######## ##
# $ $   $    #
#  ## #   #  #
# ##  ##### ##
#  #         #
#        $   #
#.@.####$## ##
#...#  #    # 
#####  ###### 
