      ###               
      # ##              
#######  ############   
#     #      #      #   
#            # #    #   
# #####$## # # # #  ####
# # #    # # #  .#  #. #
#   #    # # ## ##@ #  #
#.*##  ### # #  .##    #
#.*#   # # # #        *#
#### $ # # # #  #####  #
 #  $$$# #      #   #  #
 #   $ # #  ##  #   #. #
 ###   # ########   ####
   #   #                
   #####                
