####################       
#              #   ########
# #....      $ # #    #   #
# #.##.#### ## #  $ $     #
#  +...#  #  $ #  ###$ #  #
########  # ####$ #    ####
          #    $  # ##   # 
          # ####$ #  $ $ # 
          #       #  #   # 
          ################ 
