      #############
      #           #
    ###   $  $ $  #
    #   $   $ $ $ #
    #  ## $ # ### #
    #  #  ### # # #
    # ##$    $  # #
 ####  $  # $   # #
 #  #     ####$   #
##    $ #  $ #   ##
# $ $ #$#  # $  ## 
#...#   ####   ##  
#.#.## ##...$ ##   
#.#.#  #....  #    
#.+.   #...####    
############       
