       #####                 
       #   ################# 
####   # .                 # 
#..#   # #   $  $  ####  $ # 
#..#####     #  #  #  $ #####
#..  ..#  $ ######$#  #$#   #
#   $..#$##  #  #  # ##     #
### #..#  #        #    ## ##
  # ####  ########## # ## $# 
  # $  $  #  #     # ### $ ##
  #      ##  #  ## #        #
  ######### ### #  #######  #
   #  #   #   # # ##   #    #
   #  # # # #   #  # # # # ##
   #    #   ######   #   # # 
   # ########   #############
   #  #   #   #  #   #   # @#
   ##   #   ####   #   #   ##
   ##########  ############# 
