       #####
 #######   ##
## # @## $$ #
#    $      #
#  $  ###   #
### #####$###
# $  ### ..#
# $ $ $ ...#
#    ###...#
# $$ # #...#
#  ### #####
####