###############
#..........  .####
#..........$$.#  #
###########$ #   ##
#      $  $     $ #
## ####   #  $ #  #
#      #   ##  # ##
#  $#  # ##  ### #
# $ #$###    # # #
###  $ #  #  ### #
 ##    $ ## #  # ##
 # $  #  $  $ $   #
 #  $  $#$$$  #   #
 #  #  $      #####
 # @##  #  #  #
 ##############