         #####
     #####   #
    ## $  $  ####
##### $  $ $ ##.#
#       $$  ##..#
#  ###### ###.. #
## #  #    #... #
# $   #    #... #
#@ #$ ## ####...#
####  $ $$  ##..#
   ##  $ $  $...#
    # $$  $ #  .#
    #   $ $  ####
    ######   #
         #####