       ###########
       #   #     #
#####  #     $ $ #
#   ##### $## # ##
# $ ##   # ## $  #
# $  @$$ # ##$$$ #
## ###   # ##    #
 # #   ### #####$#
## #     $  #....#
#  ### ## $ #....##
# $   $ #   #..$. #
#  ## $ #  ##.... #
#####   ######...##
    #####    #####