  ####   
  #  ### 
  #    # 
###$.# ##
#  $.#  #
# #$. # #
#@  #   #
#########
