  ###### 
  #    ##
 ##$.#  #
 # .$@  #
## $.# ##
#  ### # 
#      # 
#####  # 
    #### 
