   #########
####@$.#   #
#   #.$    #
#    $.#####
########    
