  #####
###   #
#   # #
# #$. #
#  .$@#
###$.##
  #  # 
  #  # 
  #### 
