  ####   
  #@ #   
###$.####
#  .$   #
#  $. # #
### ##  #
  #    ##
  ###### 
