#####   
#   ####
#   $. #
####.$@#
#   $. #
#   ####
#####   
