 ##### 
 # . # 
 # * # 
## *###
#  $@ #
# # # #
#     #
#######
