########
#@ .   #
#  * # #
###*## #
#  $   #
#      #
########
