####### 
#   . ##
# # $  #
#  #*# #
##  $  #
 #@#.###
 #   #  
 #####  
