#######
#  .  #
#  $  #
###*#@#
#  $  #
#  .###
#####  
