 ####     
 #  #     
 #  ##### 
 #  ##  ##
###$$    #
# @$.##  #
#  ..## ##
#######  #
 #       #
 #   #  ##
 ######## 
