 ####     
 #  #     
 #  #     
 #  ######
###$$    #
#  $. ## #
#  ..#  @#
####   ###
   #####  
