   ### 
###  # 
#  $ ##
#@.*. #
## $  #
  ##  #
   #  #
   ####
