    #### 
    #  # 
#####  ##
#   #$  #
#   .*. #
## ##$###
#   #@#  
#     #  
####  #  
   ####  
