 ####  
 #  #  
 # $###
##.*. #
#  $  #
# # # #
#  @  #
#######
