 ######  
 #    #  
## ##$###
#   .*.@#
#   #$###
###   #  
  #####  
