######## 
#   #  # 
#      # 
## ### ##
 # $@#  #
 #$*.   #
 # .#####
 #  #    
 #  #    
 ####    
