#####   
#   ##  
#  $ ## 
##$*. ##
 # .@  #
 #  #  #
#####  #
##  ####
