 ###### 
##    ##
#  ##  #
# #  # #
#  @$# #
###$*. #
  # .###
  #  #  
  #  #  
  #  #  
  #  #  
  ####  
