  ####  
  #  #  
  #  #  
 ##* ###
##. $  #
#  * # #
# # @# #
#  ##  #
##    ##
 ###### 
