    ####    
 ####  #    
 #     #    
 #  ## ##   
 ## # * #   
  # #.@$#   
### ##* ####
#          #
#   ####   #
#####  #####
