#####     
#   ####  
#  @*  ###
###.#$   #
  # *    #
  ########
