 #####    
 #   #### 
## # #@ # 
#    #$*# 
# #   *.##
#   ##   #
#####  # #
    # #  #
    #   ##
    ##### 
