   ####
  ##  #
  #   #
 ##$* #
 # *.##
## #  #
#     #
#    ##
#  @## 
#####  
