  ####  
  #  #  
### @###
#  $*  #
#  *.  #
###   ##
  ##### 
