  ####   
  #  #   
###@ ####
#  $*   #
#  *. # #
### ##  #
  #    ##
  ###### 
