    ##### 
    #   # 
    # # ##
#####    #
#   ##$* #
#     *. #
#######@##
      ### 
