###### 
#    # 
# ##@# 
#  $$##
###$ .#
  # ..#
  #   #
  #####
