########
#      #
# #### #
# #  # #
# #  # #
# #  # #
# #$$# #
#  $@. #
### ..##
  ##### 
