######## 
#@  #  # 
# ..   ##
##.##   #
 #  $$# #
 ###$   #
   #  ###
   ####  
