  #######
  #     #
### ### #
# $ $ # #
#...@.# #
# $ $ # #
### ### #
 #      #
 #   ####
 #####   
