  ######  
 ##    #  
## @## #  
#  #  $###
#  ....$ #
#  # $   #
######$ ##
     #  # 
     #### 
