       #####      
      #  .  #     
      # $#$ #     
      #  #  #     
      #  @  #     
 ###### $#$ ##### 
 #       #      # 
##$##$  .#.  ## ##
#  $     .      .#
#    ########  ..#
######      ######
