#####             
#   ##############
# #         ######
# #   ### $  #####
#    ##.## $  ####
# #$##.. ## $  ###
#   #...  ## $  ##
# #$###    ## $  #
# # $ ##    ##  ##
#      ## #  ## @#
####   $  ##  ####
   #####      ...#
       ###########
