     ##       
#####@ ####   
#   ##    #   
# $###  $ ####
#    ###$$   #
##..      $  #
 #..#    ### #
 ######   #  #
     ##      #
      ##  . ##
       ##   # 
        ##### 
