                ####     
#####       #####  ####  
#   #########   #     #  
# # #         # # ### #  
#     $ #       #  .# #  
#####  $### ###   .## ###
    ##$ # #        .# # #
     #@## ###### ####   #
     ####      # #   # ##
               #   #   # 
               ######### 
