####             #####
#  ###############   #
#      #       $     #
# ##   . #### $#   # #
# #    #    ## $ # $ #
# # # ##.## #.  ## # #
# ### #..   #  ##    #
#   $ ###########    #
# #$#$ #      ##  # ##
##  $  #    #   $   # 
 ##  # # #### #$# ### 
  ##        #     #   
   ##   #   @  ####   
    ######.....#      
         #######      
