 #########       ############
##  ##   #########          #
#        #       ##         #
#   #### # ####$ $  # ##    #
## ####     $    #$ #  # ## #
 #      $ ######       # ## #
 #  #  ####    ###### ##    #
 # ## $#    #     $    # ## #
 #  #  #  #   # # ## # # ## #
 #$ #### $# # # #  #   #    #
 #        #  .       # # ## #
 #  #    $##.#. #$ .   # ## #
 #######     .  #  # ###    #
       #       ##$ # #      #
       #######    ## #      #
             #@    $ # ##...#
             ### $  ##  #...#
               ##  ##.  #####
                ####..  #    
                   ######    
