          #########
  #########       #
  #      $    $   #
### ##   #  ###$# #
# .  # $###$  # # #
#. . #   $        #
### ## ####### #  #
  #  #    #    #  #
  #  # ## #  ###  #
  #       .       #
  #  ####.@.#######
  ####  #####      
