##################
#       #        #
# #   #  * .#  # #
#   #    # ## .$ #
#  ###   #  ##$# #
#   #   ##  #  $ #
#      ##.  # $$ #
### ## #+.  #  ###
  #    ######  #  
  #            #  
  ##  ######  ##  
   #          #   
   ############   
