  ####   
###  ### 
#    $ ##
#  $ #  #
#  # $  #
# ##$#  #
# #    @#
#   ## ##
#####. .#
    # . #
    #.  #
    #####
