       ####       
       #  #       
########  ########
#                #
#  $ $ #  # $ $  #
# $ $  #  #  $ $ #
#  $ ###  ### $  #
# $ ##.#  #.## $ #
#  ##..#  #..##  #
# ##...#  #...## #
#                #
#      #  #      #
#      #@ #      #
##################
