        ######
######  #    #
#    ####  $ #
# #    #  ## #
#.$.#$     $ #
# .   $ $ ## #
#. .#####$ $ #
# . #   #    #
#.$.#   ######
##+##         
 ####         
