########            
#..    #            
#. #$  #            
#..  $ #            
#  #  $#            
#####  #            
    #$ #            
    # $#############
    #$             #
    #              #
    ########## #####
        #        #  
        #        #  
        ####+#####  
           ###      
