 ######## 
 #   #  # 
 ##  $  # 
 #.. #  # 
 # .##$###
#####  ..#
#  $  $ .#
# $ $  ###
#@  ####  
#####     
