######   
#..  #   
#..  #   
#.. @##  
###$..#  
#   #####
# $     #
#  # $  #
# $$$ $ #
#  $  ###
##  #### 
 ####    
