 ##### ####  
 #   # #. ## 
## $ ###.$ ##
#  $ #..    #
#  $@#.  $$ #
## $##. ##  #
 # $  .$# $ #
 ####...#   #
    #########
