#################
#      .$       #
# #####$####### #
# #   $ @ $ $ # #
# # $ .....   # #
# #####.#$##### #
#               #
#################
