  #####    
  #   #    
 ## # #### 
 # @# #. # 
 # ## $. # 
## ##..$ # 
#   $.$# ##
# # ## $  #
# $  $ .. #
########  #
       ####
