 ##########     
 #        #     
 #$$$$$$  #     
 #    # $ #     
 #$ $  $@ #     
 # $  $ ########
 #$  $     ... #
 # ########### #
#  ........... #
# ############ #
#              #
################
