#########
#   #...#
# $$@.**#
#   #*..#
# $$$.$ #
#   #*  #
# $$#.$.#
#       #
#########
