    #### 
#####  # 
#   #  # 
# $    # 
#  $#$ # 
# $ #  # 
#  $#*.# 
# $ #..# 
#  $#*.##
# $ #..@#
#  $#*. #
##  #..##
######## 
