####      
#  #      
# @###    
# $  #    
# $ $#####
# #  $...#
# $ $###.#
# $$ ....#
#     #  #
##########
