                ######   
               ## #  ##  
 ###          ## .$*  #  
## ##        ## .$*  ##  
#   ##      ## .$*  ##   
# *  ##     ##.$*  ##    
##$*  ##    #  *  ##     
# .$*  ##   # *  ##      
## .$*  #####   ##       
 ## .$*  #  ## ##        
  ## . *  $   $ #        
   ###   # .#.  #        
    ######@# # ######    
        #  .#. #   ###   
        # $   $  * . ##  
        ## ##  #  *$. ## 
       ##   #####  *$. ##
      ##  * #   ##  *$. #
     ##  *  #    ##  *$##
    ##  *$.##     ##  * #
   ##  *$. ##      ##   #
  ##  *$. ##        ## ##
  #  *$. ##          ### 
  ##  # ##               
   ######                
