 ###              ###### 
## ##            ## #  ##
#   ##          ## .$*  #
# *  ##        ## .$*  ##
##$*  ##      ## .$*  ## 
# .$*  ##     ##.$*  ##  
## .$*  ##    #  *  ##   
 ## .$*  ##  ## *  ##    
  ## . * #####    ##     
   ###   #  ## ####      
    ####  $   $ ##       
       ### .#.  #        
        ##@# # ##        
        #  .#. ###       
       ## $   $  ####    
      #### ##  #   ###   
     ##    ##### * . ##  
    ##  * ##  ##  *$. ## 
   ##  *  #    ##  *$. ##
  ##  *$.##     ##  *$. #
 ##  *$. ##      ##  *$##
##  *$. ##        ##  * #
#  *$. ##          ##   #
##  # ##            ## ##
 ######              ### 
