###########
#    *    #
#   # #   #
#  #####  #
# *#####* #
#* # # # *#
# * ### * #
#  * * *  #
##  * *  ##
###  $  ###
 ####+#### 
    ###    
