   ###   
   #.#   
   #.#   
   #.#   
   #.#   
   #.#   
 ###.### 
##     ##
#  $ $  #
# #$#$# #
#  $@$  #
##     ##
 ####### 
