#########
##  @  ##
#  $$$  #
# $ $ $ #
#  $ $  #
# $ $ $ #
# #$#$# #
# #...  #
#  ...# #
# ##.####
# #...  #
#  ...# #
# ### # #
#       #
#########
