##############
##  ##.......#
#  $ ........#
# $# #  ##  ##
#  $  #####$ #
# $ #  $  $@ #
# $  # # $#$ #
# $$ # $ $ $ #
#    #       #
##############
