#####        
#   #####    
# $$#   ###  
#    $    ## 
##$ $ $ $  # 
#   #####$ # 
#  $#     ###
#   # #####@#
##$##.....# #
#   #.##..# #
# $ #.##..$ #
#   $.....# #
#########$# #
     # $ $  #
     #      #
     ########
