##############
#.....    #  #
#.*.*.$    @ #
## ###  ##  ##
 # ##  ###$## 
 # #  ##   ## 
 # #$### #  # 
 # # $ # #  # 
 # # $ # # ## 
 # # # # # ## 
 # $ $ $ #  # 
 #          # 
 ############ 
