                  #  #  
   ###########  ########
  ##         #  # .....#
  #  $ $ $ $ ## # ...# #
  ## #######  # ##.#.# #
 ## $#  #   # #### ....#
###   $ #   $ #  # .# ##
# ####  ##$#  @ $## #$# 
# ###  ##  #  # $     # 
# #  $     # #####  ### 
# #    #$# #  #  ####   
  # #$ # $ # ##    #    
  # #  # #    #   ##    
  ######   ####         
    #  ####  #          
   ###      ###         
