       ###########
       #    #    #
       # #$   $ ##
####   # $ # #   #
#  #####  $ $ $ ##
# .# # #### # #  #
#           $   ##
# ..#.# @#$#$# $ #
# .  .####       #
# .##. ###########
# .# .  #         
#       #         
#    #  #         
#########         
