################
#           @  #
#  $ $ $ $ $ $ #
# $### ######$ #
#  ###....  #  #
# $###.###  #$ #
#  ###.###  #  #
######.###  #$ #
  ###..###  #  #
  ###.....  #$ #
  # $ ####  #  #
  #         #$ #
  #######   #  #
        ########
