        ##############
#########    #       #
#   #. .  #     $$$  #
# # .. .# ## ## #  $ #
# # .  .# #  #  $  # #
#      .# #    # $$$ #
###### ## #### #    @#
     #       # #######
     # ## #    #      
     #    #  # ##     
     #######    #     
           #    #     
           ######     
