        ##############
#########    #       #
# # #. .# #     $$$$ #
# # .. .# ## ## #  # #
#   .  .# #  #  $  # #
#   #  .# #    #$$$  #
# #### ## #### #    @#
#            # #######
#####  #  #    #      
    #######  # ##     
          ##    #     
           #    #     
           ######     
