        ##############
#########    #       #
#   #. .  #     $$$$ #
# # .. .# ## ## #  # #
#   .  .# #  #  $  # #
# ##   .# #    # $$$ #
###### ## #### #    @#
     #       # #######
     #  # #    #      
     ######  # ##     
          ##    #     
           #    #     
           ######     
