      ####      
      #..#      
      #..#  ####
   ####..####  #
####........   #
#   ........#  #
#  ####..# ##  #
##    #..#     #
#     #..#   ###
## ###########  
#            #  
##$$$$$$$$$$ #  
#           ##  
# $$$$$$ $$$#   
# #    ##   #   
# ####  @ ###   
#    $ $  #     
####$ $ $ #     
  #  $ $  #     
  #   $ $ #     
  #  ######     
  ####          
