##################
##       #      ##
#      ..## $ $  #
#  ##.*..# # $ $ #
# $# #.*..###@$  #
#   ###.*..# #   #
# $$ # #.*..# # ##
# $   ###..# ##  #
# $$ ## #.##    ##
# $  ##  .####   #
# $$ ## $. ## $ ##
# $   ###*   #   #
# $  ## #. $   $ #
#     #    ###  ##
##################
