    #########    
    #    #  #    
##### $ $ $ #####
##   # ###      #
#  # #   #$# # ##
#  ..#.### $$#  #
# #.... #  $ $$ #
#  ..#.    #  $ #
# ##### # ## #  #
#       #   @   #
#################
