              ####        
    ###########  ######   
    #  ##  #  #       ### 
    #....        ####   ##
    #....#######$#   *   #
 ####....        #  * *  #
##   ##### # # # # * * * #
# $ $      $ $ # #* * * *#
#  # ###########$# * * * #
# $ $  $ $ $ $   #  * *  #
##   #    @    #     *   #
 #########################
