###############
#      @      #
# $ $ $ $ $ $ #
#  $ $ $ $ $  #
# $ $ $ $ $ $ #
#  $ $ $ $ $  #
# $ $ $ $ $ $ #
#  $ $ $ $ $  #
# $ $ $ $ $ $ #
#  $ $ $ $ $  #
# $ $ $ $ $ $ #
#  $ $ $ $ $  #
# $ $ $ $ $ $ #
#  $ $ $ $ $  #
###$####$######
# $.*.......# #
# #.........# #
# ##.......## #
#  ##.....##  #
#   ##...##   #
# ## ##.## ## #
#    ##.##    #
#    ##.##    #
#    # .      #
#     ...#    #
#  ##.....##  #
####.......####
###.........###
###.........###
###############
