 ########
 #  ##  ####
 # @$   #  ####
 # ##$ $   #  #
 # ##  #$ $   ###
 # #####  #$ $  #
 # #   ####  #$ #
 # ##     ####  #
## .##       # ##
#.  .##      # #
#..  .##     # ##
###   .#######  #
  #  # .        #
  ###############