#############
#     @     #
# $ ##### $ #
#  $ ### $  #
##  $ # $  ##
 ##  $#$  ##
  ### # ###
   #  #  #
   #.. ..#
   #..#..#
   #######