#####
#...#
#...###
#..   #
#.    #
## #######
 # ###@  #####
 # ## $#     ##
 # # $  ## $$ ##
 # #$   ###  $ ##
 # #  ### ##  $ #
 #   ########$  #
 #            $ #
 ##  ########  ##
  ####      ####