      #####
     ##.#.##
     #  #  #
    ##$$$$$##
#####.  .  .###
#   $ # # # $ ##
#   *  .#.  *  #
## #$.#####.$# ##
 #  *  .#.  *   #
 ## $ # # # $   #
  ###. @.  . ####
    ##$$$$$###
     #  #  #
     ##.#.##
      #####