               ####
     ###########..#
 ##### $   $     .#
 # $ $ $.*.$ $ $  #
##.#.#.##@##.#.#.##
#  $ $ $.*.$ $ $ #
#.     $   $ #####
#..###########
####