       #####
       #   ##
       # .  #
  ####### # #
###   # #   #
#   # ###$###
#  $. $   # ####
## .### # ###  #
 #### #$+ $  . #
    ### ### #$ #
    #   # #   .#
    #.$ # ######
    #   #
    #####