      ####    ####
      #  #    #  #
#######  ######  ##
#   #       #     #
# # # # # # # # # #
#@$**************.#
# # # # # # # # #$#
#   #   #       #.#
###   #####  ######
  #####   #  #
          ####