    #####
    #   ####
    # $.  .#
    ##  ## #
#### #$ ## #
#  ###.##  ##
# $ $.@.$ $ #
#  ###.###  #
##.# #$# #  #
 # ### #### #
 #    $    .#
 ###   ######
   ##  #
    #  #
    ####