    #####
    #   #
    #$.$#
   ## . ##
#### $.$ ####
# $ $ . $ $ #
# ....@.... #
# $ $ . $ $ #
#### $.$ ####
   ## . ##
    #$.$#
    #   #
    #####