      #####
    ###   ##
    #   $  ####
    #  $ $   .#
  ### $$$$$ # #
 ##  #.....#  ##
##  $.##.##.$  ##
#  $$.#.. #.$$  #
# $ $...@...$ $ #
#  $$.##..#.$$  #
##  $.##.##.$  ##
 ##  #.....#  ##
  # # $$$$$ ###
  #.   $ $  #
  ####  $   #
     ##   ###
      #####