     ####
    ##  #
   ## *.#
  ##   .#
 ## $$#$##
 #   .   ##
 # $*###  #######
## .$  $ $  $   #
# ..*..*@*..*.. #
#   $  $ $  $. ##
#######   ##*$ #
      ##   .   #
       ##$#$$ ##
        #.   ##
        #.* ##
        #  ##
        ####