############
#          #
# ###### $ ##
# #  ## $ $ ##
# # ## $ $ $ ##
# ### $ $ $ $ ##
# ## $ $ $ $ $ #
# ##  $ $ $ $  #
# ###  $ @ $  ##
# ####  $ $  ####
# #.###  $  ###.#
# #...##$  ##...#
# #....# ###....#
# #..      *....#
#   $.*.. $ *.*.#
#################