#####         #####
#.. # ####### # ..#
#  .###  #  ###.  #
# .###  $$$  ###. #
##.### $   $ ###..#
#..#  $ $## $  #.##
#.   $ $   $   #..#
# .#$ $ $ $#$#$# .#
#     $ $@$ $     #
#. #$#$#$ $ $ $#. #
#..#   $   $ $   .#
##.#  $ ##$ $  #..#
#..### $   $ ###.##
# .###  $$$  ###. #
#  .###  #  ###.  #
#.. # ####### # ..#
#####         #####