          ########
         ##  #...#
       ### $ #...#
     ###   $ ##..#
   ###  $ $$ #...#
 ###  $ $# $ #...#
##  $ $ $  $ #..##
# $ $ $ $$ $ #. .#
#@$   $    $ ....#
# $ $ $ $$ $ #.  #
##  $ $ $  $ #..##
 ###  $ $  $ #...#
   ###  $ $$ #...#
     ###   $ ##..#
       ### $ #...#
         ##  #...#
          ########