#####
#   #####
# # .   #
# $$*$$ #
#...@...#
# $$*$$ #
##  . # #
 ####   #
    #####