     #####     
     #   #     
     # # #     
    ## $ ##    
   ## $.$ ##   
#### $.*.$ ####
#   $.#.#.$   #
# #$.*.#.*.$# #
#   $.#.#.$   #
#### $.*.$ ####
   ## $.$ ##   
    ## $ ##    
     # # #     
     # @ #     
     #####     
