 ####        
 #  ######   
 #   $.$ ##  
 #  $. .$ ## 
 #   # ##  # 
###$##.  $ ##
# $.## ##.$ #
# . .# #. .@#
# $.## ##.$##
## $   ##$ # 
 #  ##.#  ## 
 ## $. .$  # 
  ## $.$   # 
   ######  # 
        #### 
