###################
#   #             #
# # # #$# #$# #$# #
#   #   #   #   # #
# # # #.# #.# #.# #
#@$**************.#
### # #.# #.# #.# #
  #   #   #   #   #
  # #$# #$# #$# # #
  #               #
  #################
