     #########     
  ####       ######
###           #...#
#   # $$$$$$$ #...#
#...# $     $ #...#
#...#  $$$$$  #...#
#...## $   $ ##...#
#...##$ $$$ $##...#
#  ## $  @  $ ##  #
#  #  $$$$$$$  #  #
#  #           #  #
#  ########### #  #
#                ##
##   ###   ####   #
 ##### #####  #   #
              #####
