#########
#   #   #
#   #   #
#@$ # $ #
# $ # $ #
# $ # $ #
# *.#.* #
# * . * #
# *.#.* #
# $ # $ #
# *.#.* #
# * . * #
# *.#.* #
# $   $ #
# ***** #
#       #
#########
