    ######
    #    ###
##### ##   #
#  $ $ $   #
# #     # ##
#  $##### #
### #  $  #
  # #   # #
  #   #$  #
  # ### ###
 ##$    #
##  ######
#...@....#
## # #####
 #   #
 #####