#################
#     . . . . . #
#. # $ $ $ $ $  #
# $############ #
#. #         #  #
# $#         #$ #
#. #         # .#
# $#         #$ #
#. #         # .#
# $#         #$ #
#. #         # .#
# $#         #$ #
#  #         # .#
# ############$ #
#  $ $ $ $ $ # .#
#@. . . . .     #
#################