#################
# . . .   . . . #
#. $ $ $ $ $ $ .#
# $###########$ #
#. #         # .#
# $#         #$ #
#. #         # .#
# $#         #$ #
#  #         #  #
# $#         #$ #
#. #         # .#
# $#         #$ #
#. #         # .#
# $###########$ #
#.$ $ $   $ $ $.#
#@. . . # . . . #
#################