#################
# . . . . . . . #
#.$ $ $ $ $ $ $.#
# $###########$ #
#. #         # .#
# $#         #$ #
#. #         # .#
# $#         #$ #
#. #         # .#
# $#         #$ #
#. #         # .#
# $#         #$ #
#. #         # .#
# $###########$ #
#   $ $ $ $ $   #
#@ #. . . . .   #
#################