#################
# .#.  #    #.  #
#  $ $ $ $ $ $ .#
#.$#.#.#.#.#.#$##
## . $ $ $ $ . .#
# $#$#.#.#.#$#$ #
#  . . $ $ . .  #
# $#$#$#.#$#$#$##
#  . . .@. . .  #
##$#$#$#.#$#$#$ #
#  . . $ $ . .  #
# $#$#.#.#.#$#$ #
#. . $ $ $ $ . ##
##$#.#.#.#.#.#$.#
#. $ $ $ $ $ $  #
#  .#    #  .#. #
#################