#################
#               #
# $ *.*.$.*.* $ #
#  $ $ * * $ $  #
# * $ $.$.$ $ * #
# .$ *.*.*.* $. #
# * $.$.$.$.$ * #
# .*.*.* *.*.*. #
# $ $.$ @ $.$ $ #
# .*.*.* *.*.*. #
# * $.$.$.$.$ * #
# .$ *.*.*.* $. #
# * $ $.$.$ $ * #
#  $ $ * * $ $  #
# $ *.*.$.*.* $ #
#               #
#################