#################
#.$.#   #  .#.$ #
#   # $ #$$ #   #
# $ #.   .  # $.#
# . ###$## # $ ##
### #  .# . $  .#
#.#$#.$ # # ##  #
#.  #   #   #.$.#
#$ ####*##$####$#
#    .$ # $ .#. #
# $$ $$ * . # $ #
#. .#.. #.$ $  .#
### #$#.#####.$.#
#    $.##   #.#.#
# $ #$  $.$ #$$$#
#   #..$  *+    #
#################