 ###########
 #   #     #
 # $.$.$.$ #
 # .$.$.$. #
 # $.$.$.$ #
 # .$.@.$. #
## $.$.$.$ #
#  .$.$.$. #
#  $.$.$.$ #
#      #   #
############