  #####   #####
###...#####...###
#.$$$$$.#.$$$$$.#
#.$.$.$.#.$.$.$.#
#.$.#.$.#.$.#.$.#
#.$.$.$.$.$.$.$.#
#$$.$.$$$$$.$.$$#
#       @       #
#################