       #######
     ###.#  .#
  #### $ . *##
###.  * $ *  #
#   ## # # . #
# $  .  * # .#
## $ $ * $ ###
### $ * $ $ ##
#. # *@$.  $ #
# . # $ ##   #
#  * $ *  .###
##* . $ ####
#.  #.###
#######