  ###########
  #. #  .# .#
  # $ .*.$  #
  #  ## ##  #
  ## #.. # ##
   # #.+ # #
#### #...# ####
#  $ ## ##$$  #
# $   $.$   $ #
#  $$ ### $$  #
##    # #    ##
 ###### ######