 ###############
##     ##      ##
#  .*.  # *.*.  #
# .* *.$#$.$ *. #
# * $ * # * $ * #
# .$ $.$#$.$ $. #
# * $ * # * $.* #
# .*.*.$@$.*.*  #
# * $ * $ * $.* #
# .$ $.$ $.$ $. #
# * $ * $ * $ * ###
# .$ $.   .$ *.   #
# * $ * . *.*.  . #
#                 #
###################