            ####
####### #####  ###
#     # #        #
# ### # #  ## ## #
#     # ## #     #
## ## #  # # ### #
 # #  #### # # # #
 # #       # ### #
 # # ###   #   # ##
 #    ## ### #    #
 # #  ##$+   # ## #
 #   ### ##     # #
 #####   #  ###   #
     # # # ##   ###
     #   #    ###
     ##########