##################
#        #   ##  #
# $ $ $ $ . . . .##
#  # # # # # # #  #
# $#$ $ $#.#.#. . #
#  # # # ##  ### ##
# $ $ $ $ . ##. . #
#  # # # # . ###  #
##$#$ $ $#.#.#+ . #
#  # # # ### ###  #
# $ $ $ $ . .#. . #
#  # # # ### # # ##
# $#$ $ $#.#.# . .#
#  # # # # # ## # #
# $ $ $ $ . .  . .#
#        #   ##  ##
##################