    #####
    #   #
    #   ##
  ###$$$ #
### . . .####
#  $ .@. $  #
#  $. # .$  #
#  $ . . $  #
####. . . ###
   # $$$###
   ##   #
    #   #
    #####