     #####
    ##   #
    #    ##
    #$$$$ #
  ###. . .####
### .$.@.$.$ ##
#  $ .###. $  #
#  $. # # .$  #
#  $ .###. $  #
## $.$. .$. ###
 ####. . .###
    # $$$$#
    ##    #
     #   ##
     #####