       ####
       #..###
       #.   #
       #... ##
     ### #...#
    ##     ..#
#####   $ #  #
# $ $ $$ #####
#  $    ##
## $  $##
 # @$$ #
 ##   $#
  ##   #
   #####