#####         #####
#   ##       ##   #
# $  ##     ##  $ #
##$ $ ##   ## $ $##
 #.$ $ ## ## $ $.#
##..$ $ ### $ $..##
#..#.$ $ # $ $.#..#
# ..#.$ $ $ $.#.. #
# ####.$ @ $.#### #
#    .#.$$$.#.    #
#. #  ##. .##  # .#
#### # ## ## # ####
   #     $     #
   #. #$$ $$# .#
   ####.   .####
      #######