     ####
     #  #####
    ##      #
    # $ $ $ #
  ###  $ $###
 ##   # $ #
 # $ ##$ $#
 #  $ $   ##
## $ $   $ #
#   $ $ $@ ####
#  $ ###   ...#
#   ## ##  .#.#
#####   # #.#.#
        # #...#
        #... .#
        #. ...#
        #######