          ######
##### #####. ..##
#   # #       $ #
# #$### #$###$# #
#    $ $  # #@  #
##.. .# # # #####
 ######   #
      # #$#
      #   ######
##### #$# #. ..##
#   # #  $   $  #
# # ### # ### # #
#  $   $  # #   #
##.. .##### #####
 ######