     #####
     #...#
    ##...##
    #... .#
    #. . .#
    #.....#
    ### ###
  ###     ###
 ##   #@#   ##
 # $ $   $ $ #
##$ # $ $ # $##
#  $ $#$#$ $  #
#   # $ $ #   #
###  $ $ $  ###
  ##   #   ##
   #########