 #####    #######
##.#.######   ..#
#..#...$    ....#
#.*...##$ ###..##
# *.## $ $####. ##
#  ## $   $ ###$.#
#  # $ $ $ $ ##. #
##  $ $ $ $ $   .#
 #   $ $ $ $  # .#
 #### $ $ $ ######
    #  $@$  #
    ##  #  ##
     #######