#########
#...... #
#.#.... #
#..#.. ###
#...#. #.###
#....# $$#.###
#..    $ $ #.#
#  ##$$  $$# ###
####.$   $ $ $ #
   ###$$$# $ $ #
    #. $   $$  #
    ### $$$  $ #
     #.   $  $ #
     ###$$ $$$ #
       #      @#
       #########