    #######
    #     #    ####
    #$$$@$#  ###  #
    #   $ #  #..  #
    # # # #  #..  #
    #  $  # #### ##
    #$$ $$# #..  ##
    # # # ###.. . #
    #      #### # #
    #$   $.#..  $.#
    # $$$ ##.. $ ##
  ###     #### ###
 ##.#$# #$#..#   #
##  # $   #..# # #
#.   $ $$$     $.#
#  .#.   .#  #  ##
#################