           ####
       ##### .#
       #   #$ #
   ##### $ .  #
   #   ##  #  #
   # # $ .#####
   # $ *$ ##
   # ..@.. #
   ## $* $ #
#####. $ # #
#  #  ##   #
#  . $ #####
# $#   #
#. #####
####