   ####
 ###  ##
##     ##
#.  $  .#
##$ * $##
 # $*$ #
 ##...##
  ##.##
   #.#
  ##.##
###...###
#  $*$  #
# $ * $ #
#   $   #
##  $@ ##
 ##  ###
  ####