    #############  
    #   #   #   #  
##### # # # # # #  
#   #   #   #   #  
# #.# #.# #.# #.###
#@$*$*$*$*$*$*$*$.#
### #.# #.# #.# # #
  #   #   #   #   #
  # # # # # # # # #
  #   #   #       #
  #################
