#########
#   #   #
#.#$#$#.#
# $ + $ #
# # # # #
#  $.$  #
#.# # #.#
#   #   #
#########
