  ####### 
  # $ . # 
### #$# ##
#  $  .  #
# #.## # #
# .@$ .  #
## #$# ###
 # # $.#  
 #   ###  
 #####    
