 #####   
##   #   
#    #   
#    ####
### ##@ #
 ## ##  #
 #  ##$.#
 #    $.#
 ##  #$.#
  ####  #
     #  #
     ####
