  ######
  #    #
###$.# #
#  $.#@#
# #$.  #
#    ## 
##  ### 
#####   
