#####   
#   ####
# #$.  #
#@ $.# #
###$.  #
  #  ###
  #  #  
  ####  
