  ####  
  #  #  
  #  #  
###$.#  
#  $.###
# #$.@ #
#   ## #
###    #
  ######
