####    
#  #### 
#     # 
#  .# # 
###*# ##
 #@*   #
 # $   #
 ###  ##
   #### 
