 ##### 
##   # 
#    # 
# #.###
#  $  #
###*# #
 # $@ #
 # .  #
 ###  #
   ####
