   ####   
 ###  ####
 # .     #
 #@$  #  #
###*###  #
#  $     #
#  .###  #
##### ####
