#####   
#   ##  
# #. ###
#  $ @ #
###*   #
#  $ ###
# #.##  
#   #   
#####   
