  #####
  #   #
  # # #
###$$ #
#  $. #
# #..##
#@   # 
###### 
