######   
#    #   
# # $####
# #$*. @#
# # .#  #
#      # 
#####  # 
     ##  
