###### 
# @  # 
#  $$##
###$ .#
  # ..#
  ##  #
   #  #
   ####
