######    
#  #@#    
#  $$#####
#  $ .   #
### ..   #
  ##  ####
   ####   
