          #######
          #  ...#
      #####  ...#
      #      ...#
      #  ##  ...#
      ## ##  ...#
     ### ########
     # $$$ ##    
 #####  $ $ #####
##   #$ $   #   #
#@ $  $    $  $ #
###### $$ $ #####
     # $    #    
     #### ###    
        #  #     
        #  #     
        #  #     
        ####     
