 ######## 
 #......# 
 #..##..# 
 #......# 
 #..**..# 
 ###..### 
 #  $$  # 
 #      # 
 # $$$$ # 
###    ###
#  $$$$  #
#        #
# $$$$$$ #
##      ##
# $$$$$$ #
#   @    #
#  ####  #
####  ####
