        #########
      ###   #   #
      #@$  $ $$ #
### ######      #
#.###   ##  ##$ #
#.....*.  ## $  #
# *##  #$ #  $  #
#   #  $  ......#
## $##  #########
 # $ ####        
 # $ $ #         
 #     #         
 #######         
