   #####   
 ###   ### 
## @ $ $ # 
#  ## ## ##
# $.#.$   #
# #.#*#   #
# $...  ###
###$# ###  
  #   #    
  #####    
