    #####       
 ####   ## #####
 #  $    ###   #
 # $@$ $    $  #
 # #$######## ##
 # #  $  #     #
 # # $ $ # #   #
## #  $# # #####
#  ##    #     #
#    $ # ###   #
##### ##  #....#
#    $     ....#
#         #....#
################
