########  
# ..#  #  
# ..# $###
#  ##    #
## $   $ #
 # ##  ###
 #   $##  
 ###  #   
   #@ #   
   ####   
