 ####
 #  ####
##  $  #
# +*.$ #
# $ .  #
########
