 ####   
 #  ####
##  $  #
# @*.$ #
# $ .  #
########
