#########
#   #...#
# $$@.**#
#   #*..#
# $$# $.#
#   #$ .#
# $$# $.#
#       #
#########
