#####     
#   ######
#      ..#
#   .....#
#######.##
#  $ $ @# 
# $ $ $$# 
#  $ $  # 
#       # 
######### 
