   #####
  ##   #
 ##  $ #
 #  # ##
##* * .#
#   #  #
#@$ *.##
########
