  #######
  #     #
###$#@# #
#    *# #
# # **  #
#  * ##.#
###  ####
  #  ##  
  #####  
