         ###         
        #   #        
       #  .  #       
      # .. .  #      
      # . # . #      
      #  ...  #      
   ### #  .  # ###   
  #   ## ## # #   #  
 #  $    #   #  .  # 
# $$ $ # #     . .  #
# $ #$$# ### #..# . #
#  $ $    @### . .. #
 #  $  #   #    .  # 
  #   # # ## ##   #  
   ### #  $  # ###   
      #  $ $  #      
      # $$# $ #      
      #  $ $$ #      
       #  $  #       
        #   #        
         ###         
