#########
##  @  ##
#  $ $  #
# $ $ $ #
#  $ $  #
# $ $ $ #
#  $ $  #
# ##$## #
#  ...  #
#  ...# #
# ##.####
# #...  #
# #...# #
#   #   #
##     ##
#########
