        #############   
#########    #  #   ### 
#   #. .# #     #     # 
# # .. .# ## ##   $#$$##
#   .  .# #  #  # $  @ #
# #    .# #    ###$$$$ #
###### ## ####      #  #
     #       # ####   ##
     #  # #    #  ##### 
     ######  # ##       
          ##    #       
           #    #       
           ######       
