    #######    
   ##     ##   
  ## $$$$  ##  
 ## .. *..$ ## 
## $* .#.  $ ##
# .$  ### .$  #
# *  #.. # $* #
# . #...  # . #
#$#####$#$### #
#      $@     #
#.#####$# #####
#.  #   # $ $ #
#.# # # # $ $ #
#.  #   #     #
###############
