    #######    
   ##     ##   
  ##  $$$  ##  
 ## .* *..$ ## 
## $* .#.  $ ##
# .$  ### .$  #
# *  #.. # $* #
# . #...  # . #
#$#####$#$### #
#       @     #
# #####$# #####
#.  #   # $ $ #
#.# # # # $ $ #
#.  #   #     #
###############
