  ########
 ##  #   #
##       #
#  # .# ##
# $* **$# 
## ##.# # 
 # #@   # 
 #    ### 
 ######   
