    ###    
   #   #   
  #  *  #  
 #  *$*  # 
#  * # *  #
# *.* *.*@#
#  * # *  #
 #  *$*  # 
  #  *  #  
   #   #   
    ###    
