#############
##    *   ###
#    * *   ##
#   * * *   #
#  * * * *  #
# * * * * * #
#* * *#* * *#
# * * * * * #
#  * * * *  #
##  * * *  ##
 ##  * *  ## 
  ##  $  ##  
   ###+###   
#############
