        ###        
       #   #       
      #  *  #      
     #  *.*  #     
    #  * * *  #    
   #  * * * *  #   
  #  *$*   *$*  #  
 #  * *  $  * *  # 
#  * *   .   * *  #
# *.*  $.*.$  *.*@#
#  * *   .   * *  #
 #  * *  $  * *  # 
  #  *$*   *$*  #  
   #  * * * *  #   
    #  * * *  #    
     #  *.*  #     
      #  *  #      
       #   #       
        ###        
