    #####           
    #   #           
    #$  #           
  ###  $###         
  #  $  $ #         
### # ### #   ######
#   # ### #####  ..#
# $  $           ..#
##### #### #@##  ..#
    #      #########
    ########        
