              ######
              #  ..#
   ############  ..#
   #    #  $ $   ..#
   # $$$#$  $ #  ..#
   #  $     $ #....#
   # $$ #$ $ $#....#
####  $ #     #....#
#   # ##############
#    $  ##          
# $$#$$ @#          
#   #   ##          
#########           
