  ######  
  #    ###
  # $    #
### $ ## #
#... $   #
#...$#$ ##
#### # $ #
   #  @  #
   #######
