        ######     
        #  # ######
  ##### #  $ #....#
 ##   # #  # #....#
 # $ $ ##$## #....#
 #  #  #   # #....#
 #$ $  $@$ # ##  ##
 # $#  ## ##  #  # 
##   $$#  ### #  # 
#  $   # $$      # 
# $  $ #  ####  ## 
#    ######  ####  
######             
