             ####
      ########  #
     ## $ $   $ #
     #   @#$  $ #
     #  $ #  #  #
######## $#     #
#   $     $ $ ###
#   #####$##$##  
## $$         #  
 #  ## $ $ $  #  
 ###### # # ###  
     # $ $  #    
     #  $  ##    
    #### $###    
    #.......#    
    #.......#    
    #.......#    
    #########    
