     #####       
     #@  ####### 
   #### $  $   # 
 ###   $$ $ $  # 
 #   #  $# ##### 
 #$####  $   $ # 
 # $  $  $   $ # 
 #  $  ###$### ##
##  ## #.....#  #
#  $ $ #.....   #
# $   $ .....####
########.....#   
       #######   
