  ####### ######    
 ##     ###    #    
 #  ###   # $$ ###  
 # # @ #  #  $   #  
 # #$$$# ####$##.###
##       $   $ #...#
#  #$#$##  #   #...#
# #  $  # # ## #...#
# #     # #    #...#
#  #$$$## #$   #...#
##         $$###...#
 # #$#$## #$    ...#
 # #    # # $   ...#
 # #    # #  #######
 # #$$$## #  #      
 #        ####      
 ###    ###         
   ######           
