########          
#...   ########   
#....     $   ##  
#.....## $ #$  #  
#.....#  #  $  #  
#######$ ##  $ ###
 #        ### $  #
 #  $ # $  #  $  #
 #  ### ##  # ####
 #  #  $  $ #   # 
 #### #$#  ##$  # 
  #@$    $   $  # 
  #####   ####### 
      #####       
