     #######   
     #@ #  #   
     # $   #   
    ### ## #   
 #### $  # ##  
 #       #  ## 
 # $ $#### $ # 
 # $$ #  #  $# 
 #$  $   #$  # 
##  $$#   $$ ##
# $$  #  #  $ #
#     #### $  #
#  #$##..##   #
### .#....#####
  # .......##  
  #....   ..#  
  ###########  
