    #######     
    #   #@#     
 #### # # ##### 
 #    #       # 
 # $#$####### # 
##$   #..#..#$##
#    $$.....#  #
# $ $ #.....$$ #
##   ##...#.#  #
 # $  ##...##$ #
 # ## #######  #
 #      $ $ $ ##
 ######   $ # # 
      ## # $  # 
      # $$ $  # 
      #   $   # 
      ######  # 
           #### 
