       ####      
    ####  #      
   ##  #  #      
   #  $ $ #      
 ### #$   ####   
 #  $  ##$   #   
 #  # @ $ # $#   
 #  #      $ ####
 ## ####$##     #
 # $#.....# #   #
 #  $...*. $# ###
##  #.....#   #  
#   ### #######  
# $$  #  #       
#  #     #       
######   #       
     #####       
