############  ######
#   #    #@####....#
#   $$#       .....#
#   # ###   ## ....#
## ## ###  #   ....#
 # $ $     # ## ####
 #  $ $##  #       #
#### #  #### ## ## #
#  # #$   ## ##    #
# $  $  # ## #######
# # $ $    # #      
#  $ ## ## # #      
# $$     $$  #      
## ## ### $  #      
 #    # #    #      
 ###### ######      
