      ###     
 ######@##### 
 #..........# 
##.********.##
#..*......*..#
#..*.****.*..#
######..######
 #          # 
 # $ $$$$ $ # 
 #$$$    $$$# 
 #   $$$$   # 
 #$ $    $ $# 
##   $$$$   ##
# $$$    $$$ #
#     #      #
##############
