     ############   
     # .        #   
###### # $ * *  #   
#      ##  *##*##   
#   *   # **    ####
#  * *  #  *  **#  #
# * * * # ##  *+$* #
## * * ##  #  ###  #
# * * * #  ####   ##
#  * *  #  #   *  # 
#   *   #### #  * # 
#      ## * * *  ## 
#### ####  *   ###  
   #     *  ####    
   ##########       
