  ##### 
###   ##
# .. . #
# $$ # #
## #$$ #
 #.@  ##
 ###  # 
   #### 
