     #####
   ###   #
  ## * # #
 ##      #
## * * ###
#   $###  
#  + #    
######    
