              #####
     ##########   #
     #        #   #
     #  $ $    $$ #
     # ##### ## $ #
     #$$   #$## $ #
     # ### # ##$  #
###### ### $ $    #
#....        ##   #
#....        ######
#....        #     
###########@##     
          ###      
