 ####### 
##     ##
#  . $ @#
# $*$$. #
# $..$. #
# $..$. #
#########
