#########
#   #...#
# $$@.*.#
#   #*..#
# $$# $ #
#   #$ .#
# $$# $.#
#       #
#########
