     ########       
    #       ##      
   #  ** ##   #     
  #  * *   **  #    
 #  * *    * *  #   
#  * *   *  * *  #  
# * *   * *  * *  # 
#* *   * * *  * *  #
# *   * * * *  * * #
#*   * * * * *  ***#
#   * * * * * *    #
#  * * * . * * *@$ #
####################
