      ##########
      #..#     #
      #..#     #
   ####..####  #
####........   #
#   ........#  #
#  ####..####  #
##    #..#     #
 #    #..#     #
 # ########### #
 #             #
 #$$$$$  $$$$# #
 #           # #
 #$$$$$  $$$$# #
 #     ##      #
 #####  @ ######
 #   $ $  #     
 #  $ $ $ #     
 #   $ $  #     
 ## $ $ $ #     
  #  ######     
  ####          
