      ####    
 ######  #    
 #      $#####
 #.....  #   #
### #### #$# #
# $  @ $     #
# $ ##########
#   #         
#####         
