    ###    
   #   #   
  #  *  #  
 #  *.*  # 
#  *$ $*  #
# *. @ .* #
#  *$ $*  #
 #  *.*  # 
  #  *  #  
   #   #   
    ###    
