    ###    
   #   #   
  #  *  #  
 #  *$*  # 
#  * * *  #
# *.* *.*@#
#  * * *  #
 #  *$*  # 
  #  *  #  
   #   #   
    ###    
