    ###    
   # . #   
  #  *  #  
 #  * *  # 
#  *$ $*  #
#.*  *  *+#
#  *$ $*  #
 #  * *  # 
  #  *  #  
   # . #   
    ###    
