    ###    
   # . #   
  #  *  #  
 #  * *  # 
#  * $ *  #
#.* $*$ *+#
#  * $ *  #
 #  * *  # 
  #  *  #  
   # . #   
    ###    
