   ####  
   #  #  
   #  #  
   #  #  
#### ####
#   *  ##
#  * *  #
# * * * #
#* *#* *#
# * * * #
#  * *  #
##  $  ##
 ###+### 
   ###   
