###########
#    *    #
#   * *   #
#  * * *  #
# * * * * #
#* * * * *#
# * *#* * #
#  * * *  #
##  * *  ##
###  $  ###
#####+#####
    ###    
