###########
#    *   ##
#   * *   #
#  * * *  #
# * *#* * #
#* * * * *#
# * *#* * #
#  * * *  #
##  * *  ##
###  $  ###
 ####+#### 
    ###    
