        #        
       # #       
      #   #      
     #  *  #     
    #  * *  #    
   #  * * *  #   
  #  * * * *  #  
 #  * * * * *  # 
# .* * *$* * *@ #
 #   #  #  #   # 
  # * * * * * #  
   # * * * * #   
    # * * * #    
     # * * #     
      # * #      
       # #       
        #        
