#############
##    *   ###
#    * *  ###
#   * * *  ##
#  * * * *  #
# * * * * * #
#* * *#* * *#
# * * * * * #
#  * * * *  #
##  * * *  ##
 ##  * *  ## 
  ##  $  ##  
   ###+###   
 ########### 
