      ###      
     #   #     
    #  *  #    
   #  *.*  #   
  #  * * *  #  
 #  *$* *$*  # 
#  * *   * *  #
# *.*     *.*@#
#  * *   * *  #
 #  *$* *$*  # 
  #  * * *  #  
   #  *.*  #   
    #  *  #    
     #   #     
      ###      
