        ###        
       #   #       
      #  *  #      
     #  *.*  #     
    #  * * *  #    
   #  * * * *  #   
  #  *$*   *$*  #  
 #  * *     * *  # 
#  * *   #   * *  #
# *.*   ###   *.*@#
#  * *   #   * *  #
 #  * *     * *  # 
  #  *$*   *$*  #  
   #  * * * *  #   
    #  * * *  #    
     #  *.*  #     
      #  *  #      
       #   #       
        ###        
