        ###        
       #   #       
      #  *  #      
     #  *.*  #     
    #  * * *  #    
   #  * * * *  #   
  #  *$*   *$*  #  
 #  * *  #  * *  # 
#  * *       * *  #
# *.*  # # #  *.*@#
#  * *       * *  #
 #  * *  #  * *  # 
  #  *$*   *$*  #  
   #  * * * *  #   
    #  * * *  #    
     #  *.*  #     
      #  *  #      
       #   #       
        ###        
