          ###          
         # . #         
        #  *  #        
       #  * *  #       
      #  * * *  #      
     #  * * * *  #     
    #  * * * * *  #    
   #  * * * * * *  #   
  #  * * * * * * *  #  
 #  * * * * * * * *  # 
#  * * * * * * * * *  #
# * * * * *$* * * * *@#
#  * * * * * * * * *  #
 #  * * * * * * * *  # 
  #  * * * * * * *  #  
   #  * * * * * *  #   
    #  * * * * *  #    
     #  * * * *  #     
      #  * * *  #      
       #  * *  #       
        #  *  #        
         #   #         
          ###          
